700
3000
100000000000000000000000000000000000000000000000000000000000000000000000000000000000000000000000000000000000000000000000000000000000000000000000000001
100000000000000000000000000000000000000000000000000000000000000000000000000000000000000000000000000000000000000000000000000000000000000000000000000001
100000000000000000000000000000000000000000000000000000000000000000000000000000000000000000000000000000000000000000000000000000000000000000000000000001
100000000000000000000000000000000000000000000000000000000000000000000000000000000000000000000000000000000000000000000000000000000000000000000000000001
100000000000000000000000000000000000000000000000000000000000000000000000000000000000000000000000000000000000000000000000000000000000000000000000000001
100000000000000000000000000000000000000000000000000000000000000000000000000000000000000000000000000000000000000000000000000000000000000000000000000001
100000000000000000000000000000000000000000000000000000000000000000000000000000000000000000000000000000000000000000000000000000000000000000000000000001
100000000000000000000000000000000000000000000000000000000000000000000000000000000000000000000000000000000000000000000000000000000000000000000000000001
100000000000000000000000000000000000000000000000000000000000000000000000000000000000000000000000000000000000000000000000000000000000000000000000000001
100000000000000000000000000000000000000000000000000000000000000000000000000000000000000000000000000000000000000000000000000000000000000000000000000001
100000000000000000000000000000000000000000000000000000000000000000000000000000000000000000000000000000000000000000000000000000000000000000000000000001
100000000000000000000000000000000000000000000000000000000000000000000000000000000000000000000000000000000000000000000000000000000000000000000000000001
100000000000000000000000000000000000000000000000000000000000000000000000000000000000000000000000000000000000000000000000000000000000000000000000000001
100000000000000000000000000000000000000000000000000000000000000000000000000000000000000000000000000000000000000000000000000000000000000000000000000001
100000000000000000000000000000000000000000000000000000000000000000000000000000000000000000000000000000000000000000000000000000000000000000000000000001
100000000000000000000000000000000000000000000000000000000000000000000000000000000000000000000000000000000000000000000000000000000000000000000000000001
100000000000000000000000000010000000000000000000000000000000000000000000000000000000000000000000000000000000000000000000000000000000000000000000000001
100000000000000000000000000010000000000000000000000000000000000000000000000000000000000000000000000000000000000000000000000000000000000000000000000001
100000000000000000000000000010000000000000000000000000000000000000000000000000000000000000000000000000000000000000000000000000000000000000000000000001
100000000000000000000000000010000000000000000000000000000000000000000000000000000000000000000000000000000000000000000000000000000000000000000000000001
100000000000000000000000000010000000000000000000000000000000000000000000000000000000000000000000000000000000000000000000000000000000000000000000000001
100000000000000000000001111010000000000000000000000000000000000000000000000000000000000000000000001111100000000000000000000000000000000000000000000001
100000000000000100000010000010000000000000000000000000000000000000000000000000000000000000000001111110000000000000000000000000000000000000000000000001
100000000000000010000100000010000000000000000000000000000000000000000000000000000000000000011111100000000000000000000000000000000000000000000000000001
100000000000000001001000000000000000000000000000000000000000011111100000000000000000000011111000000000000000000000000000000000000000000000000000000001
100000000000000001000000000000000000000000000000000000000000010000000000000000000000011110000000000011111111111111111111000000000000000000000000000001
100000000000000000000000000000000000000000000000000000000111110000000000110001111111111110000000000000000000000000001111100000000000000000000000000001
100000000000000000000000000000000000000000000000000001111110000000000001111000000000000000000000000000000000000000000000110000000000000000000000000001
100000000000000000000000000000000000000000000000011111000000000000000011111100000000000000000000000000000000000000000000011000000000000000000000000001
100000000000000000000000000000000000011111111111111111000000000000000111111110000000000000000000000000000000000000000000001100000000000000000000000001
100000000000000000000200000000000001100000000000000000000000000000001111111111000000000000000000000000000000000000000000000110000000000000000000000001
100000111111111111111111111111111111100000000000000000000000000000011111111111100000000000000000000000000000000000000000000011000000000000000000000001
100001110000000000000000000000000000000000000000000000000000000001111111111111110000000000000000000000000000000000000000000001100000000000000000000011
111111000000000000000000000000000000000000000000000000000000000011111111111111111000000000000000000000000000000000000000000000111111111111111111111111
111111111111111111111111111111111111111111111111111111111111111111111111111111111111111111111111111111111111111111111111111111111111111111111111111111

